1111111111111111111111111
10000000001100000000000011111111
101100000111000000000000100000001
100100000000000000000000111111111
111111111011000001110000000000001
10000000001100000111011111111111
11110111111111011100000010001
111111111111110111010100100011111111111
11000000110101011100000010001
10000000000000001100000010001111
100000000000000011010100100000001
11000001110101011111011110001111
1110111111010110111101000111
1111111111111111111111111